7 9 160
S..#..*..
.##..#..*
..*..#...
..##..*..
....*....
..*..#..*
..#...*..